========
=@     =
=      =
=      =
=     K=
========
$$$
========
=@     =
=      =
=      =
=     K=
========