=========================================
=                                       =
=                                       =
=                 F@GMTK                =
=       ========================        =
=       ========================        =
=                                       =
=                                       =
=                                       =
=========================================

